level0
1,2 3 1 4
1,1 1,1 4 2,1

level1
2 4 8 4,3 2,2 1 3 3
1,1 3 5 5 1,1 1,1 2,2 3,1 5

level2
1 2,1 1,3 5,2 4,3 2,6,1 5,3 6,1 4,5 3,1 3 2
2 5 2,3 2 2,4 2,7 10 9 3 1,2 1,2 1,1 1,1 1,2

level3
1,3 2,1,1,1 2,2,2 12 8 5 4 4 5,1 3,3 5 5,1 1,1,4 1,3 1
1,1,1 3,1 5 2 3 8,1 9,1 10,1 9,2,1 1,2,1,2 1,1,1,2 1,1,1,1 1,1,1 1,1,1 1,1